111111111111111111111111
100000001000000100000001
1000P0001000000100000001
100000001000000100000001
100000001000000100000001
100000001000000100000001
100000001000000100000001
100101001000000100000001
111101111000000100000001
100000001000000100000001
100000001000000111111111
100100001000000100000001
100000001000000100000001
100000001000000100000001
100000001000000100000001
100100001000000100000001
100000001000000100000001
100000001000000100000001
100000001000000100000001
100100001000000100000001
100000001000000100000001
100000001111111100000001
100000000000000100000001
100100000000000100000001
100000000000000100000001
100000000000000100000001
100000000000000100000001
100000000000000100000001
100000000000000100000001
100000000000000100000001
100000000000000100000001
111111111111111111111111