111111111111111111111111111111111111111111111111111111111111111111111111
100001000000000000100000000000000000000000000001100000000000000000000001
100001000000000000100000000000000000000000000001100000000000000000000001
1000010000000P0000100000000000000000000000000001100000000000000000000001
100001000000000000100000000000000000000000000001100000000000000000000001
100001000000000000100000000000000000000000000001100000000000000000000001
1000010000000M0000100000000000000000000000000001100000000000000000000001
100001000000000000100000000000000000000000000001100000000000000000000001
100001000000000000100000000000000000000000000001100000000000000000000001
100001000000000000100000000000000000000000000001100000000000000000000001
100001000000000000100000000000000000000000000001100000000000000000000001
100001000000000000100000000000000000000000000001100000000000000000000001
100001000000000000100000000000000000000000000001100000000000000000000001
100001000000000000100000000000000000000000000001100000000000000000000001
100001000000000000100000000000000000000000000001100000000000000000000001
100001000000000000100000000000000000000000000001100000000000000000000001
100001000000000000100000000000000000000000000001100000000000000000000001
100001000000000000100000000000000000000000000001100000000000000000000001
100001000000000000100000000000000000000000000001100000000000000000000001
100001000000000000100000000000000000000000000001100000000000000000000001
100001000000000000100000000000000000000000000001100000000000000000000001
100001000000000000100000000000000000000000000001100000000000000000000001
100001000000000000100000000000000000000000000001100000000000000000000001
100001000100001000100000000000000000000000000001100000000000000000000001
100001000100001000100000000000000000000000000001100000000000000000000001
100001000100001000100000000000000000000000000001100000000000000000000001
100001111100001111100000000000000000000000000001100000000000000000000001
100000000000000000000000000000000000000000000001100000000000000000000001
100000000000000000000000000000000000000000000001100000000000000000000001
100000000000000000000000000000000000000000000001100000000000000000000001
100000000000000000000000000000000000000000000001100000000000000000000001
100000000000000000000000000000000000000000000001111111111111111111111111
100000000000000000000000000000000000000000000001111111111111111111111111
100000000000000000000000000000000000000000000001100000000000000000000001
100000000000000000000000000000000000000000000001100000000000000000000001
100000000000000000000000000000000000000000000001100000000000000000000001
100000000000000000000000000000000000000000000001100000000000000000000001
100000000000000000000000000000000000000000000001100000000000000000000001
100000000000000000000000000000000000000000000001100000000000000000000001
100000000000000000000000000000000000000000000001100000000000000000000001
100000000000000000000000000000000000000000000001100000000000000000000001
100000000000000000000000000000000000000000000001100000000000000000000001
100000000000000000000000000000000000000000000001100000000000000000000001
100000000000000000000000000000000000000000000001100000000000000000000001
100000000000000000000000000000000000000000000001100000000000000000000001
100000000000000000000000000000000000000000000001100000000000000000000001
100000000000000000000000000000000000000000000001100000000000000000000001
100000000000000000000000000000000000000000000001100000000000000000000001
100000000000000000000000000000000000000000000001100000000000000000000001
100000000000000000000000000000000000000000000001100000000000000000000001
100000000000000000000000000000000000000000000001100000000000000000000001
100000000000000000000000000000000000000000000001100000000000000000000001
100000000000000000000000000000000000000000000001100000000000000000000001
100000000000000000000000000000000000000000000001100000000000000000000001
100000000000000000000000000000000000000000000001100000000000000000000001
100000000000000000000000000000000000000000000001100000000000000000000001
100000000000000000000000000000000000000000000001100000000000000000000001
100000000000000000000000000000000000000000000001100000000000000000000001
100000000000000000000000000000000000000000000001100000000000000000000001
100000000000000000000000000000000000000000000001100000000000000000000001
100000000000000000000000000000000000000000000001100000000000000000000001
100000000000000000000000000000000000000000000001100000000000000000000001
100000000000000000000000000000000000000000000001100000000000000000000001
100000000000000000000001111111111111111111111111100000000000000000000001
100000000000000000000001111111111111111111111111100000000000000000000001
100000000000000000000000000000000000000000000001100000000000000000000001
100000000000000000000000000000000000000000000001100000000000000000000001
100000000000000000000000000000000000000000000001100000000000000000000001
100000000000000000000000000000000000000000000001100000000000000000000001
100000000000000000000000000000000000000000000001100000000000000000000001
100000000000000000000000000000000000000000000001100000000000000000000001
100000000000000000000000000000000000000000000001100000000000000000000001
100000000000000000000000000000000000000000000001100000000000000000000001
100000000000000000000000000000000000000000000001100000000000000000000001
100000000000000000000000000000000000000000000001100000000000000000000001
100000000000000000000000000000000000000000000001100000000000000000000001
100000000000000000000000000000000000000000000001100000000000000000000001
100000000000000000000000000000000000000000000001100000000000000000000001
100000000000000000000000000000000000000000000001100000000000000000000001
100000000000000000000000000000000000000000000001100000000000000000000001
100000000000000000000000000000000000000000000001100000000000000000000001
100000000000000000000000000000000000000000000001100000000000000000000001
100000000000000000000000000000000000000000000001100000000000000000000001
100000000000000000000000000000000000000000000001100000000000000000000001
100000000000000000000000000000000000000000000001100000000000000000000001
111111111111111111111111111111111111111111111111111111111111111111111111